Name,EX,EW,Subtotal-(EX+EW),CR(PE),CR(PEW),Subtotal-(EX+EW+CR(PE)+CR(PEW)),CR,EN,VU,Subtotal(threatened spp.),LR/cd,NT or LR/nt,LC or LR/lc,DD,Total
Antarctica,0,0,0,0,0,0,0,1,7,8,0,5,162,35,210
Bouvet Island,0,0,0,0,0,0,0,0,2,2,0,0,94,3,99
Fr. S. Antarctic Lands,1,0,1,1,0,2,5,11,16,32,0,8,983,56,1080
Heard Island and McDonald Islands,0,0,0,0,0,0,0,4,9,13,0,1,126,7,147
South Georgia and the South Sandwich Islands,0,0,0,0,0,0,0,4,5,9,0,6,196,13,224
Anguilla,1,0,1,0,0,1,9,19,40,68,0,19,1158,66,1312
Antigua and Barbuda,3,0,3,0,0,3,12,19,42,73,0,24,1281,66,1447
Aruba,0,0,0,0,0,0,7,16,35,58,0,21,1115,53,1247
Bahamas,2,0,2,1,0,3,15,30,55,100,0,37,1725,115,1979
Barbados,1,0,1,3,0,4,13,19,40,72,0,26,1280,68,1447
Bermuda,5,0,5,1,1,7,31,15,30,76,0,21,950,69,1121
Bonaire, Sint Eustatius and Saba,1,0,1,0,0,1,11,16,48,75,0,24,1240,74,1414
Cayman Islands,2,0,2,0,0,2,12,24,35,71,0,30,1187,70,1360
Cuba,7,0,7,3,0,10,38,83,84,205,0,65,1818,135,2230
Curaçao,0,0,0,0,0,0,10,19,40,69,0,22,1134,77,1302
Dominica,1,0,1,1,0,2,11,22,42,75,0,30,1313,69,1488
Dominican Rep.,9,0,9,6,0,15,34,72,74,180,0,61,1484,78,1812
Grenada,0,0,0,0,0,0,11,18,43,72,0,24,1258,70,1424
Guadeloupe,7,0,7,2,0,9,13,25,47,85,0,33,1241,68,1434
Haiti,10,0,10,13,0,23,73,63,74,210,0,53,1424,75,1772
Jamaica,3,0,3,5,0,8,25,49,55,129,0,41,1338,76,1587
Martinique,6,0,6,3,0,9,11,20,33,64,0,25,1214,59,1368
Montserrat,0,0,0,1,0,1,9,17,41,67,0,23,1172,57,1319
Puerto Rico,5,0,5,6,0,11,19,31,43,93,0,38,1511,84,1731
Saint Barthélemy,0,0,0,0,0,0,6,14,30,50,0,13,818,38,919
Saint Kitts and Nevis,1,0,1,0,0,1,10,16,42,68,0,24,1229,63,1385
Saint Lucia,3,0,3,0,0,3,10,26,40,76,0,26,1278,60,1443
Saint Martin (French part),0,0,0,1,0,1,9,16,40,65,0,17,1042,64,1188
Saint Vincent and the Grenadines,1,0,1,0,0,1,9,21,43,73,0,26,1308,67,1475
Sint Maarten (Dutch part),0,0,0,1,0,1,9,16,40,65,0,15,1019,57,1156
Trinidad and Tobago,0,0,0,0,0,0,15,23,53,91,1,38,1963,89,2182
Turks and Caicos Islands,0,0,0,0,0,0,7,19,43,69,0,26,1198,66,1359
Virgin Islands, British,0,0,0,2,0,2,14,21,43,78,0,25,1268,71,1442
Virgin Islands, U.S.,1,0,1,5,0,6,11,22,35,68,0,25,1251,70,1415
China,4,1,5,16,0,21,115,205,331,651,1,250,4429,1065,6401
Hong Kong,0,0,0,1,0,1,13,25,42,80,1,30,988,91,1190
Japan,14,1,15,1,0,16,56,175,281,512,3,279,3496,493,4798
North Korea,1,0,1,0,0,1,9,30,57,96,0,38,744,71,950
South Korea,1,0,1,0,0,1,15,43,71,129,0,55,1295,110,1590
Macao,0,0,0,0,0,0,5,10,11,26,0,4,424,32,486
Mongolia,0,0,0,0,0,0,5,11,23,39,0,29,554,10,632
Taiwan,0,0,0,0,0,0,27,75,227,329,2,220,3089,311,3951
Åland Islands,0,0,0,0,0,0,0,0,0,0,0,0,19,1,20
Albania,1,0,1,1,0,2,23,51,75,149,0,87,1057,73,1367
Andorra,0,0,0,0,0,0,0,3,10,13,0,20,315,7,355
Austria,3,0,3,4,0,7,24,29,51,104,0,81,861,66,1115
Belgium,1,0,1,0,0,1,6,5,35,46,0,50,716,38,851
Bosnia and Herz.,0,0,0,0,0,0,13,32,64,109,0,69,920,88,1186
Bulgaria,0,0,0,0,0,0,16,17,72,105,0,86,954,71,1216
Croatia,1,0,1,3,0,4,37,45,108,190,0,98,1224,118,1631
Czechia,0,0,0,0,0,0,4,10,30,44,0,55,714,39,852
Denmark,0,0,0,0,0,0,7,7,41,55,0,44,700,31,830
Estonia,0,0,0,0,0,0,2,3,18,23,0,29,522,9,583
Faroe Islands,1,0,1,0,0,1,5,5,20,30,0,17,306,19,373
Finland,0,0,0,0,0,0,4,2,23,29,0,40,545,14,628
France,8,0,8,6,0,14,35,66,172,273,0,162,1964,278,2685
Germany,4,0,4,5,0,9,18,28,64,110,0,85,956,81,1236
Gibraltar,0,0,0,0,0,0,8,9,36,53,0,21,542,31,647
Greece,4,0,4,11,1,16,81,118,252,451,0,161,1556,258,2430
Greenland,1,0,1,0,0,1,2,5,20,27,0,9,217,19,273
Guernsey,0,0,0,0,0,0,1,1,11,13,0,3,200,12,228
Holy See (Vatican City State),0,0,0,0,0,0,0,0,2,2,0,3,21,2,28
Hungary,0,0,0,0,0,0,7,16,41,64,0,54,701,47,866
Iceland,1,0,1,0,0,1,5,7,21,33,0,20,357,26,437
Ireland,1,0,1,0,0,1,11,10,40,61,0,37,782,63,944
Isle of Man,0,0,0,0,0,0,1,2,4,7,0,3,79,6,95
Italy,3,0,3,7,0,10,52,102,184,338,0,200,1639,255,2435
Jersey,0,0,0,0,0,0,1,1,12,14,0,2,207,12,235
Latvia,0,0,0,0,0,0,2,3,24,29,0,40,563,16,648
Liechtenstein,0,0,0,0,0,0,0,1,6,7,0,24,399,7,437
Lithuania,0,0,0,0,0,0,2,2,21,25,0,36,548,15,624
Luxembourg,0,0,0,0,0,0,2,3,7,12,0,22,457,12,503
Malta,0,0,0,0,0,0,12,12,35,59,0,26,575,43,703
Monaco,0,0,0,0,0,0,10,8,26,44,0,13,391,26,474
Montenegro,1,0,1,1,0,2,21,33,64,118,0,87,995,77,1278
Netherlands,1,0,1,0,0,1,8,4,36,48,0,51,765,36,901
Macedonia,2,0,2,2,0,4,19,35,67,121,0,60,733,50,966
Norway,0,0,0,0,0,0,8,10,43,61,0,47,674,28,810
Poland,1,0,1,0,0,1,3,12,36,51,0,60,766,34,912
Portugal,6,0,6,17,0,23,113,106,148,367,0,147,1721,313,2554
Romania,2,0,2,2,0,4,19,28,74,121,0,74,943,74,1214
San Marino,0,0,0,0,0,0,1,0,3,4,0,5,61,4,74
Serbia,0,0,0,1,0,1,10,12,49,71,0,64,833,27,995
Slovakia,0,0,0,0,0,0,6,12,35,53,0,60,732,44,889
Slovenia,0,0,0,0,0,0,16,29,112,157,0,57,1096,82,1392
Spain,2,0,2,12,0,14,80,146,235,461,0,276,2203,485,3427
Svalbard and Jan Mayen,0,0,0,0,0,0,0,1,10,11,0,8,74,3,96
Sweden,0,0,0,0,0,0,6,7,39,52,0,54,694,31,831
Switzerland,6,0,6,0,0,6,4,16,52,72,0,68,791,58,995
United Kingdom,2,0,2,0,0,2,14,20,61,95,0,59,1001,66,1223
Belize,1,0,1,0,0,1,11,34,62,107,0,54,2124,93,2379
Costa Rica,4,0,4,9,0,13,40,93,160,293,0,102,3503,238,4140
El Salvador,0,0,0,0,0,0,8,27,56,91,0,45,1641,84,1861
Guatemala,3,0,3,5,0,8,47,96,130,273,0,82,2874,166,3398
Honduras,4,0,4,10,0,14,67,84,113,264,0,84,3090,156,3598
Mexico,20,9,29,36,3,68,205,354,371,930,1,220,5048,592,6820
Nicaragua,1,0,1,0,0,1,26,39,100,165,0,76,2993,159,3394
Panama,2,0,2,8,1,11,56,93,134,283,0,115,3610,300,4310
Algeria,2,1,3,0,0,3,22,42,81,145,0,54,959,134,1295
Egypt,1,1,2,0,0,2,20,41,131,192,2,131,1814,176,2317
Libya,0,1,1,0,0,1,16,20,48,84,0,28,719,60,892
Morocco,2,0,2,0,0,2,35,64,104,203,0,77,1487,167,1936
Tunisia,11,0,11,1,0,12,21,28,64,113,0,47,879,93,1143
W. Sahara,0,1,1,0,0,1,13,24,45,82,0,34,958,94,1169
Canada,9,0,9,3,0,12,18,31,84,133,0,67,1935,93,2237
Saint Pierre and Miquelon,0,0,0,0,0,0,2,5,16,23,0,15,403,17,458
United States of America,237,4,241,29,0,270,227,308,571,1106,5,336,5790,634,8112
Belarus,0,0,0,0,0,0,3,2,22,27,0,38,485,8,558
Moldova,1,0,1,0,0,1,6,5,22,33,0,33,446,6,519
Russia,3,1,4,2,0,6,30,50,118,198,0,126,1779,237,2344
Ukraine,2,0,2,1,0,3,12,27,55,94,0,66,901,77,1140
American Samoa,1,0,1,0,0,1,3,21,79,103,3,79,1259,57,1502
Australia,42,0,42,7,0,49,136,257,620,1013,3,441,5975,694,8168
Christmas Island,4,2,6,1,0,7,3,16,31,50,0,27,943,32,1058
Cocos (Keeling) Islands,0,0,0,0,0,0,1,13,34,48,0,24,847,31,950
Cook Islands,15,0,15,0,0,15,1,16,54,71,1,49,1019,50,1205
Fiji,1,0,1,5,0,6,28,54,172,254,3,159,1845,134,2396
French Polynesia,60,11,71,2,0,73,46,27,70,143,2,58,1299,109,1682
Guam,5,1,6,0,0,6,8,27,72,107,2,93,1238,105,1551
Kiribati,1,0,1,0,0,1,0,18,97,115,3,115,1289,64,1587
Marshall Islands,0,0,0,0,0,0,1,15,93,109,3,117,1335,63,1627
Micronesia, Federated States of,2,0,2,1,0,3,6,30,140,176,3,145,1664,126,2116
Nauru,0,0,0,0,0,0,1,11,80,92,0,108,1036,39,1275
New Caledonia,5,0,5,3,0,8,45,69,164,278,3,156,2225,187,2854
New Zealand,23,0,23,8,0,31,48,80,117,245,0,64,1085,210,1627
Niue,0,0,0,0,0,0,1,14,45,60,0,51,889,34,1034
Norfolk Island,8,0,8,0,0,8,2,12,36,50,0,25,639,27,749
Northern Mariana Islands,2,0,2,0,0,2,9,25,72,106,3,92,1309,71,1583
Palau,1,0,1,13,0,14,28,36,128,192,4,144,1922,107,2370
Papua New Guinea,1,0,1,2,0,3,57,93,309,459,3,287,4147,535,5432
Pitcairn,0,0,0,0,0,0,1,8,28,37,1,22,525,27,612
Samoa,2,0,2,0,0,2,5,21,77,103,3,81,1358,77,1624
Solomon Is.,2,0,2,3,0,5,16,41,191,248,3,197,2255,148,2853
Tokelau,0,0,0,0,0,0,1,12,47,60,2,55,903,34,1054
Tonga,2,0,2,2,0,4,12,25,71,108,3,67,1438,60,1678
Tuvalu,0,0,0,0,0,0,1,15,88,104,3,110,1098,46,1361
United States Minor Outlying Islands,1,0,1,0,0,1,4,9,63,76,1,73,1260,53,1464
Vanuatu,1,0,1,0,0,1,2,24,116,142,3,132,1838,95,2211
Wallis and Futuna,0,0,0,0,0,0,2,13,79,94,0,91,1212,50,1447
Argentina,3,3,6,6,0,12,41,73,116,230,0,128,2341,184,2889
Bolivia,0,0,0,9,0,9,36,33,89,158,2,99,2430,136,2825
Brazil,11,2,13,13,0,26,117,181,311,609,9,241,5203,857,6932
Chile,1,0,1,3,0,4,25,62,82,169,0,82,1316,202,1770
Colombia,1,0,1,43,0,44,128,241,373,742,2,264,5551,590,7150
Ecuador,8,0,8,42,0,50,113,168,301,582,2,202,3668,378,4840
Falkland Is.,1,0,1,0,0,1,0,8,11,19,0,10,284,17,331
French Guiana,0,0,0,0,0,0,13,23,50,86,1,41,2198,92,2418
Guyana,0,0,0,0,0,0,14,36,66,116,2,52,2438,106,2714
Paraguay,0,3,3,2,0,5,7,11,31,49,0,62,1184,41,1339
Peru,1,0,1,10,0,11,58,158,213,429,2,201,4082,481,5196
Suriname,0,0,0,0,0,0,10,23,50,83,0,48,2301,95,2527
Uruguay,2,0,2,2,0,4,22,35,59,116,0,51,1033,63,1265
Venezuela,1,0,1,14,0,15,68,132,186,386,1,167,4060,325,4940
Bangladesh,0,0,0,0,0,0,38,66,83,187,0,80,1628,108,2003
Bhutan,0,0,0,0,0,0,8,18,34,60,0,42,721,6,829
British Indian Ocean Territory,0,0,0,0,0,0,3,15,79,97,2,103,1065,46,1313
Brunei,0,0,0,0,0,0,14,53,96,163,0,127,1623,90,2003
Cambodia,0,0,0,1,0,1,41,71,169,281,0,170,2196,190,2837
Disputed Territory,0,0,0,0,0,0,1,6,14,21,0,5,1109,35,1170
India,0,0,0,6,0,6,105,250,404,759,2,331,4392,869,6353
Indonesia,3,0,3,22,3,28,189,346,659,1194,4,647,6451,1433,9732
Laos,1,0,1,2,0,3,41,57,98,196,0,94,1544,225,2060
Malaysia,1,0,1,13,0,14,102,193,445,740,3,439,4254,506,5943
Maldives,0,0,0,0,0,0,6,25,60,91,2,93,1356,73,1615
Myanmar,0,0,0,1,0,1,45,96,186,327,3,258,3259,434,4281
Nepal,0,0,0,0,0,0,14,29,54,97,0,70,1281,65,1513
Philippines,15,0,15,8,0,23,65,200,423,688,4,352,3754,622,5435
Singapore,1,0,1,1,0,2,21,56,214,291,3,227,1902,156,2580
Sri Lanka,18,0,18,9,0,27,95,150,164,409,2,172,2078,163,2842
Thailand,2,0,2,5,0,7,64,133,347,544,2,364,4037,532,5481
Timor-Leste,0,0,0,0,0,0,8,18,24,50,0,39,1451,61,1601
Vietnam,1,0,1,9,0,10,85,159,288,532,2,246,3466,647,4894
Angola,0,0,0,0,0,0,24,53,83,160,0,66,2913,214,3353
Benin,0,0,0,0,0,0,26,34,54,114,0,53,1911,94,2172
Botswana,0,0,0,0,0,0,4,12,16,32,0,26,1325,8,1391
Burkina Faso,0,1,1,0,0,1,8,13,11,32,0,20,926,9,988
Burundi,0,0,0,0,0,0,6,20,32,58,0,39,1154,37,1288
Cabo Verde,1,0,1,0,0,1,12,23,42,77,0,29,922,89,1118
Cameroon,0,0,0,6,0,6,81,132,124,337,0,88,2944,199,3568
Central African Rep.,0,0,0,0,0,0,10,15,23,48,0,29,1588,53,1718
Chad,0,1,1,1,0,2,11,13,21,45,0,22,936,13,1017
Comoros,0,0,0,1,0,1,7,30,91,128,0,110,1381,77,1696
Congo,0,0,0,0,0,0,19,31,74,124,0,52,2200,129,2505
Dem. Rep. Congo,0,0,0,4,0,4,40,97,161,298,0,107,4037,412,4854
Côte d'Ivoire,0,0,0,2,0,2,29,57,88,174,0,84,2243,124,2625
Djibouti,0,0,0,0,0,0,11,22,89,122,0,119,1503,114,1858
Eq. Guinea,0,0,0,0,0,0,23,44,63,130,0,47,1684,105,1966
Eritrea,0,0,0,0,0,0,17,33,102,152,0,132,1691,118,2093
Eswatini,0,0,0,0,0,0,4,11,17,32,0,20,1091,5,1148
Ethiopia,0,0,0,2,0,2,17,43,58,118,0,45,1639,75,1877
Gabon,0,0,0,0,0,0,20,44,74,138,0,54,2252,151,2595
Gambia,0,0,0,0,0,0,25,31,59,115,0,50,1663,101,1929
Ghana,0,0,0,2,0,2,38,42,82,162,0,80,2343,117,2702
Guinea,0,0,0,1,0,1,29,65,105,199,0,75,2224,133,2631
Guinea-Bissau,0,0,0,0,0,0,23,30,56,109,0,47,1631,98,1885
Kenya,2,0,2,18,0,20,57,76,161,294,2,179,3701,247,4425
Lesotho,0,0,0,0,0,0,0,8,8,16,0,19,479,3,517
Liberia,0,0,0,2,0,2,31,49,75,155,0,69,1925,114,2263
Madagascar,13,0,13,10,0,23,158,344,330,832,2,302,2475,448,4072
Malawi,1,0,1,4,0,5,28,29,35,92,0,65,1792,60,2010
Mali,0,1,1,0,0,1,7,14,21,42,0,23,1063,12,1141
Mauritania,0,1,1,0,0,1,23,34,69,126,0,51,1501,108,1787
Mauritius,45,0,45,1,0,46,19,49,122,190,2,113,1513,143,2006
Mayotte,5,0,5,0,0,5,2,19,85,106,0,111,1222,59,1503
Mozambique,1,0,1,2,0,3,25,68,150,243,2,184,3641,231,4302
Namibia,1,0,1,0,0,1,14,36,56,106,0,53,2112,91,2363
Niger,0,1,1,0,0,1,7,12,18,37,0,21,808,6,873
Nigeria,0,1,1,3,0,4,40,70,90,200,0,78,2721,135,3135
Réunion,21,0,21,1,0,22,11,28,96,135,0,100,1324,95,1675
Rwanda,1,0,1,0,0,1,11,19,31,61,0,34,1150,19,1265
Saint Helena, Ascension and Tristan da Cunha,28,0,28,13,0,41,46,58,39,143,0,15,615,52,853
Sao Tome and Principe,0,0,0,0,0,0,10,24,34,68,0,17,767,96,948
Senegal,0,1,1,0,0,1,28,51,77,156,0,64,2026,133,2380
Seychelles,20,0,20,29,0,49,86,160,153,399,2,122,1653,114,2310
Sierra Leone,0,0,0,1,0,1,28,46,78,152,0,72,1988,125,2337
Somalia,0,0,0,1,0,1,16,38,112,166,0,139,2477,227,3009
South Africa,6,0,6,6,0,12,87,184,208,479,2,207,4057,346,5097
S. Sudan,0,0,0,0,0,0,7,17,20,44,0,21,1278,22,1365
Sudan,0,1,1,0,0,1,19,33,99,151,0,127,2287,138,2704
Tanzania,2,1,3,61,1,65,130,164,266,560,0,221,4320,354,5458
Togo,0,0,0,1,0,1,29,29,53,111,0,50,1914,92,2167
Uganda,0,0,0,28,0,28,49,42,74,165,0,61,2127,125,2478
Zambia,0,0,0,0,0,0,10,27,39,76,0,41,2131,74,2322
Zimbabwe,0,0,0,1,0,1,9,17,26,52,0,33,1715,26,1826
Afghanistan,0,0,0,0,0,0,4,10,26,40,0,30,611,19,700
Armenia,0,0,0,0,0,0,7,8,25,40,0,39,476,18,573
Azerbaijan,0,1,1,2,0,3,13,10,31,54,0,42,590,45,732
Bahrain,0,0,0,0,0,0,11,15,36,62,0,54,651,31,798
Cyprus,0,0,0,1,0,1,14,24,37,75,0,38,666,62,841
Georgia,0,0,0,0,0,0,7,10,38,55,0,47,607,25,734
Iran, Islamic Republic of,0,1,1,1,0,2,26,46,100,172,0,101,1729,161,2164
Iraq,0,0,0,1,0,1,13,20,60,93,0,72,959,48,1172
Israel,4,0,4,0,0,4,28,49,127,204,0,136,1643,151,2138
Jordan,0,0,0,0,0,0,5,26,90,121,0,117,1288,98,1624
Kazakhstan,1,1,2,2,0,4,15,19,43,77,0,38,773,60,950
Kuwait,1,0,1,0,0,1,9,18,45,72,0,56,769,34,932
Kyrgyzstan,0,0,0,0,0,0,1,12,25,38,0,24,469,14,545
Lebanon,0,0,0,0,0,0,13,29,48,90,0,40,742,67,939
Oman,0,0,0,0,0,0,14,41,80,135,0,92,1625,129,1981
Pakistan,0,0,0,0,0,0,25,63,111,199,0,101,1717,112,2129
Palestine,0,0,0,0,0,0,5,16,22,43,0,24,381,22,470
Qatar,0,0,0,0,0,0,12,15,43,70,0,54,680,25,829
Saudi Arabia,1,0,1,0,0,1,14,39,111,164,2,137,1662,150,2116
Syria,1,0,1,6,0,7,22,39,65,126,0,50,884,86,1147
Tajikistan,0,0,0,1,0,1,3,10,24,37,0,21,469,26,553
Turkey,4,0,4,12,0,16,72,112,125,309,0,104,1324,190,1931
Turkmenistan,0,1,1,1,0,2,11,14,30,55,0,30,583,44,713
United Arab Emirates,0,0,0,0,0,0,13,30,50,93,0,57,1099,57,1306
Uzbekistan,0,0,0,2,0,2,9,11,28,48,0,28,517,22,615
Yemen,2,0,2,1,0,3,12,38,122,172,0,150,1994,185,2503